New game=新游戏
Beta=测试
Reset=重置
Cloud Load=加载云存档
Cloud load=加载云存档
Import Save=导入存档
Import save=导入存档
Load Manual=加载手动存档
Manual Save=手动保存
Auto Save=自动保存
Export Save=导出存档
Cloud Save=云存档
Save=保存
Reset password=重置密码
Verify account=验证账户
Delete account=删除账户
Language=语言
Layout=布局
Update log=更新日志
click (tap) to start=点击(触摸)以开始
ver=版本
Load from save file=从存档文件载入
Auto Save will be overwritten.=自动保存将被覆盖.
Show=显示
Welcome!=欢迎!
Do you really want to start from the beginning?=你真的想从头开始吗?
Yes=是
OK=好
Click to Start=点击以开始
current version=当前版本
Now Loading...=正在加载中...
You have lived your whole life in this small village with your father.=你和你父亲在这个村庄里度过了一生。
Will anything ever change?=会有什么改变吗？
Let's start off by talking to your father.=让我们先和你父亲谈谈。
Click (or tap) "Get Motivated!" in the "Instant Action" column to gain "Destiny" by using your "Action" points.=点击（或触摸）“立即行动”栏中的“获得激励！”，使用“行动”点数获得“命运”。
Auto=自动
Shipyard=雕刻家
Intermediate Thunder Magic=中级雷电魔法
Click to exit =点击退出
Low cpu mode=低能耗模式
Main=主界面
MAIN=主界面
Party=队伍
PARTY=队伍
Story=故事
STORY=故事
Shop=商店
SHOP=商店
Options=选项
Other=其他
Achievements=成就
Main Menu=主菜单
There was no Offline Bonus.=没有离线奖励。
Offline Bonus=离线奖励
Announcements=公告
Do you want to load the game?=你想载入游戏吗？
Village=村庄
A small village. The people live on farming and logging.=一个小村庄。 人们以耕种和伐木为生。
Area=区域
Instant Action=即时行动
Instant action=即时行动
Loop Action=循环行动
Loop action=循环行动
Upgrade Action=升级行动
Next Action=下一步行动
Dungeon=地下城
Common Action=一般行动
Area Action=区域行动
Energy=能量
Action=行动
The power you have to act upon the world.=你对世界采取行动的力量。
Click to open the help section=点击以打开帮助部分
Get Motivated!=获得动力!
Gain the power to shape your Destiny by pushing the limits of your body.=通过突破身体极限获得塑造命运的力量。
cost=花费
complete effects=完成效果
complete effect=完成效果
Destiny=命运
progress effect=进度效果
Rest=休息
Talk with Father=与父亲交谈
My son, you must be strong.=我的孩子，你要变强
Click (or tap) "Rest" in the "Loop Action" column to continually restore action points. "Rest" will stay selected when you click "Get Motivated!" again.=点击（或触摸）“循环行动”栏中的“休息”可不断恢复行动点数。 当你单击“获得动力！”时，“休息”将再次保持选中状态。
Great! Let's keep using "Get Motivated".=很好！ 让我们继续使用“获得动力”。
Select "Talk with Father" in the "Upgrade Action" column.\n\nUpgrade Actions are the key to progressing through the story.=在“升级行动”栏中选择“与父亲交谈”。\n\n升级行动是推进故事的关键。
"Next Action" is a kind of Upgrade Action that has a particularly large impact on the storyline.\n\nIf you're stuck, check to see if there are any "Upgrade Actions" or "Next Actions" that have not been cleared.=“下一步行动”是升级行动的一种，对剧情的影响特别大。\n\n如果卡住了，看看有没有什么“升级行动”或者“下一步行动”没有完成.
This is the end of the tutorial! If you need more information, you can look in the following places:\n\n1. Hover the mouse over everything you see and look for the tooltips that appear.\n2. Click the [?] button next to "Main Menu" in the top left of the screen to open the full Help section.\n3. Hover over the [Tips] button that sometimes appears in the top right of the screen or click it to open the full Help section.\n4. Click one of the external resources on the "Other" tab.=教程到此结束！ 如果你需要更多信息，可以查看以下位置：\n\n1. 将鼠标悬停在你看到的所有内容上，然后查找出现的提示信息。\n2. 单击屏幕左上角“主菜单”旁边的 [?] 按钮以打开完整的帮助部分。\n3. 将鼠标悬停在有时会出现在屏幕右上角的 [提示] 按钮上，或单击它以打开完整的帮助部分。\n4. 单击“其他”选项卡上的外部资源之一。
Go to the Village=前往村庄
Let's go outside. You shouldn't stay home forever.=让我们到外面去吧。 你不应该永远呆在家里。
Training room=训练室
Training Room=训练室
Now, let's practice. I'll teach you how to be strong.=现在，让我们练习。 我会教你如何变强。
Your mother was taken away by the Demon King. I want you to rescue her.=你妈妈被魔王带走了。 我想要你去救她。
Home=家
Town=城镇
Only you can enter this dungeon.=只有你可以进入这个地下城。
reward=奖励
First Clear Bonus=首次通关奖励
first clear bonus=首次通关奖励
complete bonus=完成奖励
each clear bonus=每次通关奖励
each clear bonus up to 5=每次通关奖励直到5
floor :=层：
Physical Seed=物理种子
Magical Seed=魔法种子
Special Seed=特殊种子
Eat this seed to gain a tiny bit of physical power.=吃下这颗种子可以获得一点点物理能力
Eat this seed to gain a tiny bit of magical power.=吃下这颗种子可以获得一点点魔法能力
new=新
Seed=种子
Seeds=种子
Done=完成
You can increase stats with "seeds". Use them in the "Level Up" section of the "Party" tab.=你可以使用“种子”增加属性。 在“队伍”选项卡的“升级”部分使用它们。
Unlock=解锁
Resource=资源
You got out of =你已离开
You've entered =你已进入
Drop=掉落
Father=父亲
You were offline for=你离线时间为
times=次
Defeated=击败
Exp=经验
exp=经验
HP=生命值
Hp=生命值
MP=法力值
Mp=法力值
Lv=等级
Lv.=等级
event and so on=事件等
Resource Log=资源日志
Title=称号
Statistics=状态
to Title Screen=到标题画面
Shortcut Template=快捷方式模板
Auto Sacred Ritual=自动神圣仪式
They can be used in the "Level Up" section of the "Party" tab.=它们可以在“派对”选项卡的“升级”部分中使用。
"Seeds" are used to increase stats.=“种子”用于增加属性。
Drink Tea=喝茶
LOOT=战利品
loot=战利品
Magic Book=魔法书
Add=新增
Modify=修改
Fix=修复
You=你
Your Chronicle=你的编年史
Log in and load save data from the server. You must have a cloud save in the game.\n\n* We cannot guarantee the stability and compatibility of saved data as this feature is still under development.=登录并从服务器加载保存数据。 游戏中必须有云存档。\n\n* 我们无法保证存档数据的稳定性和兼容性，因为该功能仍在开发中。
Kreds=信誉
levels=级
Level=等级
About Stamina=关于体力
Cellar=地窖
History Book=历史书籍
Knight Commander=骑士指挥官
Luck=幸运
Magical Attack=魔法攻击
Magical Defense=魔法防御
rank=段位
Number of allies with maxed luck=幸运值达到最大值的队友数量
Number of open Bronze chest=打开青铜宝箱的数量
Ruby=红宝石
Total=总计
Total Exp=总计经验
Kind Woman=善良的女人
Slime Lover=史莱姆情人
Norn=女巫
Girl=女孩
Bishop=主教
Spearman=长矛兵
The cloud save has been canceled.=云存档已取消。
Potion=药水
level up cost=升级成本
additive effects=附带效果
Auto-Level Up=自动升级
All=全部
ATK=攻击
Atk=攻击
PATK=物攻
PAtk=物攻
PDEF=物防
PDef=物防
MATK=魔攻
MAtk=魔攻
MDEF=魔防
MDef=魔防
Start training. And listen to your father.=开始训练。 并且听你父亲的话。
party template=队伍模板
Party template=队伍模板
1st=第一
Click to pay the cost and get the effect immediately. You can do this as many times as you want.\n\nTo use an instant action multiple times, press the [A] key on PC or tap "Use All" on mobile.\n\nThis will use the instant action 4000x by default. You can change the default value in the options.\n\nYou can set an instant action to a shortcut slot.=点击支付费用并立即获得效果。 你可以根据需要多次执行此操作。\n\n要多次使用即时行动，请在 PC 上按 [A] 键或在移动设备上点击“全部使用”。\n\n这将默认使用即时操作 4000 次。 你可以更改选项中的默认值。\n\n你可以将即时操作设置到快捷槽。
Click to start a looping action.\n\n     The "Complete Effect" is earned when the bar is filled. When there is a progress effect, it is earned every second. Only one loop action can be selected at a time, but it will continue for as long as you want.\n\nTo stop the loop action, press the press [L] key on PC or tap "Stop" on mobile.\n\nYou can set loop actions to a shortcut slot.=点击以开始循环操作。\n\n 当栏被填满时获得“完整效果”。 当有进度效果时，它是每秒获得的。 一次只能选择一个循环动作，但它会持续到你想要的时间为止。\n\n要停止循环动作，请在 PC 上按 [L] 键或在移动设备上点击“停止”。\n \n你可以将循环操作设置到快捷槽。
Click to pay the cost and get the effect immediately.\n\nMost disappear once used, but some upgrade actions can be repeated a few times. Completed Upgrade actions increase Guardian's Bane.\n\nSome upgrade actions lock others.\n\nYou can set upgrade actions to a shortcut slot if you have previously cleared them.=点击支付费用并立即获得效果。\n\n大部分使用一次就消失，但有些升级动作可以重复几次。 已完成的升级操作会增加 守护者的祸根。\n\n一些升级操作会锁定其他操作。\n\n如果你之前已完成它们，则可以将升级操作设置到快捷槽。
Next Action is an Upgrade Action that has a large impact on the story.\n\nCompleted Next actions increase Guardian's Bane.\n\nYou can set next actions to a shortcut slot if you have previously cleared them.=下一步行动是一个对故事有很大影响的升级行动。\n\n完成的下一步行动会增加守护者的祸根。\n\n如果你之前已经完成了下一步行动，你可以将它们设置到快捷槽。
Clear the dungeon to get rewards.\n\nEnemies can drop research, seeds, and other items. Use dropped research to summon an ally.\n\nDungeon will automatically be re-entered. If you fail to clear a dungeon, there is a longer delay before you re-enter.\n\nTo enter a dungeon without opening the battle screen, press [Shift] + click on PC or tap "Sneak" on mobile.\n\nTo exit a dungeon, press the [D] key on PC or tap "Stop" on mobile.\n\nYou can set dungeons to a shortcut slot.=通关地牢以获得奖励。\n\n敌人会掉落研究、种子和其他物品。 使用掉落的研究来召唤队友。\n\n地牢将自动重新进入。 如果你未能通关地牢，在你重新进入之前会有更长的延迟。\n\n要在不打开战斗屏幕的情况下进入地牢，请在 PC 上按住 [Shift] 并单击或在移动设备上点击“潜行”。\n\n要退出地牢，在 PC 上按 [D] 键或在移动设备上点击“停止”。\n\n你可以将地牢设置到快捷槽。
Select members to participate in the battle.=选择参战的成员
Level Up=升级
Strengthen allies.=加强队友。
Party Menu=队伍菜单
Party slot=队伍槽
Party Slot=队伍槽
Close=关闭
Cactus=仙人掌
Clear=通关
Physical Attack=物理攻击
Physical Defense=物理防御
Potato=土豆
Wood=木头
Name=名称
Edit Name=编辑名称
Villager=村民
Change Title=更改称号
Title List=称号列表
Current Title=当前称号
Additional Effect=附带效果
Tips=提示
Titles grant various abilities. Only one title can be selected at a time.=称号赋予各种能力。 一次只能选择一个称号。
Just a villager. There is no special effect.=只是一个村民。 没有什么特别的效果。
Core Stats=核心属性
Core stats=核心属性
Core stats factor=核心属性因子
Final stats=最终属性
factor=因子
Core stats are shared stats with all allies.\n\nEach allies have own factor to Core stats.\n\ni.e)\nCore Stats 100 * Factor 80% \= Final Stats 80.=核心属性是与所有队友共享的属性。\n\n每个队友都有自己的核心属性因子。\n\n例如)\n核心属性 100 * 因子 80% \= 最终属性 80。
Ally tooltip shows=队友提示信息显示
BASE=基础
Set Skill=设置技能
Skill=技能
skill=技能
Effect Summary=效果总计
Template =模板
Click=点击
to switch to this template.=切换到此模板
to save over a template.=保存到此模板
to change the template's name.=重命名此模板
You can also set templates as a shortcut=你还可以将模板设置为快捷方式
General=常规
You can also switch between them by pressing the [S] key.=你也可以通过按 [S] 键在它们之间切换。
attribute=属性
condition=状况
weapon=武器
in party=在队伍中
passive skill=被动技能
Passive Skill=被动技能
effect=效果
effects=效果
interval=间隔
Interval=间隔
Exp drop amount=经验掉落量
Sacred Ritual=神圣仪式
Habit=习惯
Habit efficiency=习惯效率
Habit Efficiency=习惯效率
Reserve=保留
Reserved=保留
Input name or effects...=输入名称或效果...
Input passive skill...=输入被动技能...
Edit filtering=编辑筛选
Edit Filtering=编辑筛选
Effect=效果
Exit Editing=退出编辑
This is a function to hide allies from your list.\n\nPress "Edit Filtering" to start editing. Allies that are unchecked won't be appear in your list.\n\nPress "Exit Editing" to apply it.=这是一个从你的列表中隐藏队友的功能。\n\n按“编辑筛选”开始编辑。 未选中的队友不会出现在你的列表中。\n\n按“退出编辑”以应用它。
You're editing filtering now. Press "Exit Editing" to apply it.=你正在编辑筛选。 按“退出编辑”应用它。
You've edited allies manually. If you can't find your ally, press "Edit Filtering" again.=你已手动筛选队友。 如果找不到你的队友，请再次按“编辑筛选”。
Skill Book=技能书
Skill List=技能列表
Default Skill=默认技能
Assigned Skill=已分配技能
Assign=分配
Remove=移除
Empty=空
Tackle=反抗
Shop Menu=商店菜单
Story Menu=故事菜单
Story Flow=故事流程
History=历史
Chronicle=编年史
Key item=关键物品
Willing Revenge=渴望复仇
A Moment of Peace=片刻的平静
Hero of the Holy Sword=圣剑英雄
The End of Revenge=最后的复仇
Each Feeling=每一个感觉
Thirst for Victory=胜利的渴望
Let's start adventure.=让我们开始冒险。
Blessing=祝福
Book=书籍
Dark=黑暗
Earth=土
Fire=火
Water=水
Wind=风
Destiny of Strife=纷争的命运
Queue Slot=队列槽
God's Guidance=神的指引
Pioneer of Destiny=命运的先驱
Summon familiar=召唤密友
Summon=召唤
Will=意志
Inspiration=灵感
Multiplicative factor for Offline Bonus=离线奖励的乘数
Stamina=体力
You can see the story you made.=你可以看到你创造的故事。
You can see what kind of world exists.=你可以看到存在什么样的世界。
You can see what stories exist.=你可以看到存在哪些故事。
Item=物品
You can use the items you have.=你可以使用你拥有的物品。
Doubles habit efficiency for 1 hour.=习惯效率加倍，持续 1 小时。
Calculated after all other bonuses=在所有其他加成之后计算
Multiple uses will increase the duration but not the effect.=多次使用会增加持续时间，但不会增加效果。
When the game is closed, both the effect and time remaining are paused.=当游戏关闭时，效果和剩余时间都会暂停。
Doubles seed drop amount for 1 hour.=种子掉落量加倍，持续 1 小时。
Doubles research drop amount for 1 hour.=研究掉落量加倍，持续 1 小时。
Doubles exp drop amount for 1 hour.=经验掉落量加倍，持续 1 小时。
research=研究
Research=研究
Drop chance=掉落率
Drop Chance=掉落率
Use=使用
Increases drop chance by 1.5x for 1 hour.=增加 1.5 倍掉落几率，持续 1 小时。
A letter=一封信
Hi,\n\nThis game has been published on Steam thanks to your support!\nWe're glad that we can continue developing it and that more players play it :)\nPlease accept this small token of our appreciation.\nWe will continue to do our best on the development!\n\nEnjoy!\nSamurai Games=您好，\n\n感谢您的支持，这款游戏已在 Steam 上发布！\n我们很高兴我们可以继续开发它，并且有更多的玩家玩它:)\n请接受我们的感谢。\n我们会继续 为开发尽最大努力！\n\n尽情享受吧！\nSamurai Games
Hi,\n\nThanks to your support, we were able to release the newest version of this game!\nVersion 2.0.0 is now available on all current platforms, a well as the App Store and the Google Play Store!\nPlease accept this small token of our appreciation. :)\nWe will continue to do our best with development!\n\nEnjoy!\nSamurai Games=您好，\n\n感谢您的支持，我们得以发布该游戏的最新版本！\n2.0.0 版现已在所有当前平台以及 App Store 和 Google Play Store 上可用！\n请接受 这是我们的感激之情。 :)\n我们会继续努力开发！\n\n尽情享受吧！\nSamurai Games
shortcut slot=快捷槽
Shortcut slot=快捷槽
You can buy items using rubies.=你可以使用红宝石购买物品。
You can buy rubies.=你可以购买红宝石。
Buy=购买
This can be purchased only once.=这只能购买一次。
Starter Pack=入门包
Item Request=物品请求
Increase habit efficiency, making the progress bar in routine going two times faster for one hour.=提高习惯效率，使事务的进度条两倍快，持续一小时。
Read item menu for detail.=阅读项目菜单了解详情。
Ink=墨水
Double the amount of seeds dropped from monsters for one hour, level up to infinity and beyond!=怪物身上掉落的种子数量翻倍，持续一小时，升级到无限甚至更高！
Double exp gained from monsters for one hour, make sacred rituals faster and increase end run bonuses from experience=从怪物身上获得双倍经验，持续一小时，使神圣仪式更快，并从经验中增加结束运行奖励
Double research gained from monsters, perfect for leveling up your summons quicker and for getting greed leveled faster=从怪物身上获得双倍研究，非常适合更快地升级召唤物和更快地获得贪婪
+50% chance to drop item, research and seeds from monster for one hour. More, More, MORE!=+50% 几率从怪物身上掉落物品、研究和种子一小时。更多，更多，更多！
i.e)=例如)
10% with this item would be 15%=使用后10% 将是 15%
Auto Level Up Slot=自动升级槽
Auto Summon Slot=自动召唤槽
Auto Low CPU=自动低能耗模式
Periodically invest a certain amount of each seed on a chosen party member.=定期将一定数量的每种种子投资于选定的成员。
Help greatly with seed management and party level up.=极大地帮助种子管理和队伍的升级。
can be upgraded in Astral World=可以在星界升级
Periodically invest research on a selected party member.=定期对选定的成员进行研究。
Ease the burden of leveling up when grinding a dungeon for leveling up a summon.=减轻刷地下城升级召唤时升级的负担。
Add one slot for passive party member and benefit from their passives bonuses.=为被动成员增加一个位置并从他们的被动奖励中受益。
The Holy Grail.=圣杯。
You can't have too many!=你不能拥有太多！
Allow one more template for your party to save and load your favorite team in the blink of an eye.=为你的队伍再添加一个模板，眨眼间即可保存和加载你最喜爱的队伍。
Add one more action shortcut.=再添加一个动作快捷方式。
Save your time!=节省你的时间
This template can save shortcut slots.=该模板可以保存快捷槽。
NOTE=注意
This is not a shortcut slot.=这不是一个快捷槽
The function to load a shortcut template is not a function to execute all registered shortcuts at once, but a function to load the saved shortcut slots into the current shortcut slots.=加载快捷方式模板的功能不是一次执行所有已注册的快捷方式的功能，而是将保存的快捷方式槽加载到当前快捷方式槽中的功能。
More idleness, less going back and forth to rank up and collect the so awaited inspiration and habit points!=更多的闲散，更少的来回段位和收集期待已久的灵感和习惯点！
can be activated/deactivated in ritual tab=可以在仪式选项卡中激活/停用
This button is if the purchase process is interrupted.\n\nIf you don't get your purchased item by pressing this button, please contact support.\n\n- The iOS version allows data restoration for one-time items.\n- Steam Overlay should be enabled on the Steam version.=此按钮用于购买过程中断。\n\n如果你没有通过按此按钮获得购买的物品，请联系支持人员。\n\n- iOS 版本允许对一次性物品进行数据恢复。\n- 应在 Steam 版本上启用 Steam Overlay。
Steam Overlay should be enabled on the steam version.=应在 Steam 版本上启用 Steam Overlay。
The in-game content and game balance are subject to change without notice.=游戏内内容和游戏平衡如有更改，恕不另行通知。
Number of rank up=段位提升数
Number of dark ritual=黑暗仪式数
Number of open Gold chest=打开黄金宝箱的数量
Number of open Silver chest=打开白银宝箱的数量
Number of reincarnation=转世数
habit efficiency=习惯效率
talent=天赋
Gluttony=暴食
Gluttony's capacity=暴食上限
Greed=贪婪
Greed's capacity=贪婪上限
Greed multiplier=贪婪倍数
Quest=任务
Quest Slot=任务槽
Quest Clear=完成任务
Quest Refresh=刷新任务
Auto Eat Slot=自动进食槽
Auto recoverer=自动恢复器
Auto Recoverer=自动恢复器
Highlight Resource=高亮资源
You can get rewards here.=你可以在这里获得奖励。
Maxed Ally Filter=最大化队友过滤器
Maximum Tackle=Maximum 反抗
Animation=动画
Dark Mode=暗色主题
Scientific Notation=科学计数法
Allow Hiding Tooltip=允许隐藏提示信息
Disable Set Skill=禁用设置技能
Dark Ritual Window=黑暗仪式确认
Dark ritual=黑暗仪式
Disable Color=禁用颜色
Dungeon Log=地下城日志
Hide Purchased Items=隐藏已购买物品
Use all=全部使用
Use All=全部使用
Setting for Use All=设置为使用全部
Enable Pins=启用固定
Next Action Window=下一步行动确认
SN digit=科学计数法位数
Check this to show a box around resources when you hover over a corresponding action.=选中此项以在将鼠标悬停在相应的操作上时在资源周围显示一个框
Check this to enable messages in the event log when Loop Action stops because you run out of supplies or your inventory is full.=当循环行动因耗材用完或库存已满而停止时，选中此项以在事件日志中启用消息。
Check this to filter allies on the level up tab with maxed luck and seed levels.=选中此项以在升级选项卡上过滤具有最大运气和种子级别的队友。
When unchecked, this reduces the amount of animations on the battle screen.=取消选中时，这会减少战斗屏幕上的动画数量。
Check and restart to change from light mode to dark mode.=选中并重新启动以从亮色主题更改为暗色主题。
Check this to enable scientific notation.=选中此项以启用科学记数法。
NOTE : It's under preparation. Some notation may be overflowed.=注意：它正在准备中。 一些符号可能会溢出。
Numbers greater than or equal to this will be displayed in scientific notation. Lower numbers will be in standard notation.=大于或等于此的数字将以科学记数法显示。 较低的数字将采用标准符号。
Check this to enable the shortcut [T] to toggle tooltips on and off.=选中此项以启用快捷方式 [T] 来打开和关闭提示信息。
Check this to use "Default Skills" instead of "Assigned Skills".=选中此项以使用“默认技能”而不是“分配的技能”。
This may be useful when you want to store energy.=当你想保留能量时，这可能很有用。
Check this to enable the confirmation pop-up before a Dark Ritual.=选中此项以在黑暗仪式之前启用确认弹出窗口。
Check this to disable color in tooltip.=选中此项以禁用提示信息中的颜色。
Check this to enable a maximum of 30 FPS (This is the recommended setting). This an option for those who want to change the maximum FPS with their graphics card.=选中此项以启用最大 30 FPS（这是推荐的设置）。 对于那些想要用他们的显卡更改最大 FPS 的人来说，这是一个选项。
Check this to enable dungeon log summaries in the event log.=选中此项以在事件日志中启用地牢日志摘要。
Check this to display the names of Additional Effects instead of icons on equipment tooltips.=选中此项以在装备提示信息上显示附加效果的名称而不是图标。
Check this to filter out purchased items from the shop.=选中此项以过滤掉从商店已购买的商品。
If checked, the "Use All" instant action will run until the complete effect is maxed out.=如果选中，“全部使用”即时行动将运行，直到效果完全达到最大值。
If unchecked, the "Use All" instant action will run as long as the complete effect does not exceed the limit.=如果未选中，只要完整效果不超过限制，“全部使用”即时操作就会运行。
"Use all" or the [A] key defaults to 4000 instant action uses. Change the default value here.=“全部使用”或 [A] 键默认为 4000 次即时操作使用。 在此处更改默认值。
Check this to enable pinning and unpinning of various content with right click.=选中此项以启用通过右键单击固定和取消固定各种内容。
Check this to enable the confirmation pop-up before clearing Next Action.=选中此项以在通关下一步操作之前启用确认弹出窗口。
Choose the number of seconds before low CPU mode automatically activates. If the value is 0, it will disable. Auto Low CPU only works when the application is in the background.=选择低能耗模式自动激活前的秒数。 如果值为 0，它将禁用。 自动低能耗模式 仅在应用程序处于后台时有效。
You have to re-open start screen.=你必须重新打开开始界面。
Cleared=完成
Cancel=取消
Tap=触摸
Button=按钮
Are you really ok=你真的确定吗
A mode that omits processing and suppresses CPU usage to play this game in background.=一种省略处理并抑制 CPU 使用率以在后台玩此游戏的模式。
Save data to the device. This save is different from the auto-save. Saved data can be loaded from the start screen.=将数据保存到设备。 此保存不同于自动保存。 可以从开始屏幕加载保存的数据。
Save data to the server. You must log in or sign up.=将数据保存到服务器。 你必须登录或注册。
We cannot guarantee the stability and compatibility of saved data as this feature is still under development.=我们无法保证保存数据的稳定性和兼容性，因为该功能仍在开发中。
Save data to the text file.=将数据保存到文本文件。
You can get a bronze chest once every 20 hours.=你每 20 小时可以获得一次青铜宝箱。
Available=可得到
Manually perform an auto-save. The auto-save is executed when the game ends and periodically during the game.=手动执行自动保存。 自动保存在游戏结束时执行，并在游戏过程中定期执行。
Send verification email=发送验证邮件
EMAIL_NOT_FOUND=未找到该邮箱
Reset Password=重置密码
Processing=处理中
Go back to start screen.=返回开始屏幕。
Your save data WON'T be deleted.=你的保存数据不会被删除。
Click to open our Discord server=点击打开我们的 Discord 服务器
Click to open the community driven wiki page=单击以打开社区驱动的 wiki 页面
It has a different name because this game was renamed.=它有一个不同的名字，因为这个游戏曾经重命名了。
Local save failed=本地保存失败
You saved successfully.=你已成功保存。
d=天
h=时
H=时
m=分
's=的
s=秒
Farmwork=农活
Dim Cave=昏暗的洞穴
Orc=兽人
Wheat=小麦
Salt=盐
Anchovy Sandwich=凤尾鱼三明治
Glowing Mana Shard=发光的法力碎片
Destroyer Key=毁灭者钥匙
Hermit Key=隐士钥匙
Arbitrator Key=仲裁者密钥
Creator Key=创造者密钥
Dominator Key=支配者钥匙
Dungeon reset=地下城重置
Crystal converter=水晶转换器
Earth Armor=土护甲
Water Armor=水护甲
Wind Armor=风护甲
Bracers of Ashes=灰烬护腕
Greaves of Battle=战斗护胫
Sword of Power=力量之剑
Chestplate of Blindness=失明胸甲
Shortcut Slot=快捷槽
Eat=吃
Old lady=老太太
Okay. Bring it on.=好的。 来吧。
Fight Father=与父亲战斗
Sloth=怠惰
Sloth Overlay=怠惰叠加层
Sloth Overlay enables editing Sloth on every screens.=怠惰叠加层允许在每个屏幕上编辑怠惰。
Press [O] to open/close Sloth Overlay screen.=按 [O] 打开/关闭 怠惰叠加层屏幕。
Queue=队列

Appraise Herbs=鉴定草药
Animal Attack=动物攻击
Affectionate Left Arm=深情的左手
Automation=自动化
Ask about school=询问学校
About School=关于学校
About Stamina=关于体力
Alley=胡同
A Girl is Crying=一个女孩在哭
Bird=鸟
Bandits Escape=土匪逃脱
Bat=蝙蝠
Bar=条
Bacon 'n' Eggs=培根鸡蛋
Baked Apple=烤苹果
Brain Domination=大脑支配
Current Gold=当前金币
Cook=烹饪
Cooked Rice=米饭
Cafeteria=自助餐厅
Chop Wood=砍木头
Churn Butter=搅拌黄油
Camp=营地
City Gate=城门
Class Routine=课程事务
Dragon Baby=幼龙
Drain Gel=排水凝胶
Departure=启程
Def=防御
DEF=防御
Disabled in options=在选项中禁用
Dark Wave=黑暗浪潮
Dark Cap Extension=黑暗上限扩展
Duel with Sigurd=与席格德决斗
Equip Automation Slot Exp=装备自动化槽经验
exp / cost=经验 / 成本
Eat everything.=什么都吃。
Eh? Is it real? ...huh! You're pretty good! But that's still not enough! Hmph!=嗯？ 这是真的吗？ ……嗯！ 你很不错！ 但这还不够！ 哼！
Easy to process leather.=易于加工皮革。
Edge of Town=城镇边缘
Event=事件
Elemental Master=元素大师
Edit=编辑
Earth Regeneration Efficiency=土再生效率
Fire Drake=火焰幼龙
Failed to load.=加载失败。
Forest Hut=森林小屋
Forest=森林
Forge=锻造
Forest Fairy=森林精灵
Factors for a New Story=一个新故事的要素
Friendly Angel=友善天使
Flower Fairy=花仙子
Will Gain=会得到
Guard=守卫
Goblin=哥布林
Honey=蜂蜜
Hell Butterfly=地狱蝴蝶
Holy Light=圣光
Hat Man=帽子男
Hunting Bolt=狩猎螺栓
Honey Apple=蜂蜜苹果
Import=导入
Into the Cellar=进入地窖
Item Pouch=物品袋
Inventory=库存
Intellectual Dryad=智慧树妖
Into the Abyss=进入深渊
Limit FPS=限制 FPS
Lostlorn Forest=失落之森
Loop Action Queue=循环动作队列
Mana Bite=法力叮咬
Make Grilled Fish=做烤鱼
Make Meat Festival=举办肉食节
Man=男人
Mercenary=雇佣兵
Meat Festival=肉食节
Memory Awakener=记忆唤醒者
Moon Forest - Abyss=月之森 - 深渊
Make Pork Steak=制作猪排
Make Rice Ball=制作米饭球
Meunière=磨坊
Next strategy :=下一步策略：
No Trespassing=禁止擅自进入
Oblivion=遗忘
OTHERS=其它
Purple Slime=紫色史莱姆
Put in=放入
Pride level effect=自豪等级效果
ROUTINE=事务
Royal Herb=皇家草药
Ritual=仪式
Rock Spider=岩蛛
Routine Level=事务等级
Routine=事务
Rune=符文
RITUAL=仪式
Refuse Payment=拒绝付款
Refine Mithril=精炼秘银
Routine effect=事务效果
Scrap Bone=碎骨
Select=选择
Snake=蛇
Stone=石头
Select School=选择学校
Soldier=士兵
Swamp=沼泽
Spearsmith=长矛匠
Sell Paper=卖纸
Sell God's Grief=出售上帝的悲伤
Slums=贫民窟
Speed multiplier=速度倍数
Sharp Spike=锋利的尖刺
Stamina Regeneration Efficiency=体力恢复效率
Stone Crab=石蟹
Slime=史莱姆
Stench=恶臭
Satiety=饱腹感
Sell Elixir=出售仙丹
Sacred Bird Chick=神圣的小鸟
Spirit Water=灵水
Steel Sword=钢剑
Small Hill=小山
Saved the Girl=救了那个女孩
Topaz=黄玉
The Beginning=开端
Tamer School=驯兽师学校
Tree Golem=树人魔像
Tamer=驯兽师
Talk with Mayor=和市长交谈
Talk with Iari=与伊阿里交谈
There were no Offline Bonus.=没有离线奖励。
Undead Priest=亡灵牧师
Unnatural Wall=不自然的墙
Use Potion=使用药水
Virtue=美德
Wolf=狼
Water Magic Class - Primary=水魔法课 - 初级
When you defeat the monsters outside, it's time to know about summoning.=当你打败外面的怪物时，是时候了解召唤了。
You can manage various settings.=你可以管理各种设置。
You help out on the farm and get paid for it. And you get an extra sandwich.\nThis cannot be done after you leave the village.=你在农场帮忙并得到报酬。 你会得到一个额外的三明治。\n你离开村庄后就不能这样做了。
You are currently using a layout for PCs. Would you like to change to a layout for mobile or touch screens?=你当前正在使用 PC 布局。 你想更改为移动设备或触摸屏的布局吗？
You are currently using a layout for mobile or touch screens. Would you like to change to a layout for PC?=你当前正在使用移动设备或触摸屏的布局。 你想更改为 PC 布局吗？
Energy Recovery=能量恢复
Apple=苹果
Apple Max+=苹果上限+
Ally=队友
Ally Level Up=队友升级
Astral World=星界
Beef Max+=牛肉上限+
Beer Max+=啤酒上限+
Bean Max+=豆子上限+
Wreath Max+=花环上限+
Wine Max+=酒上限+
Beer=啤酒
Bean=豆子
Beast King=兽王
Basic=基础
Warrior=战士
Warrior School=战士学校
Warrior Talent=战士天赋
water=水
Magic Class - =魔法课 - 
Waterball=水球
Waterfall=瀑布
Effects=效果
Yellow Slime=黄色史莱姆
Gray Slime=灰色史莱姆
Golden Slime=金色史莱姆
White=白
 Cap+=上限+
Wheat=麦子
Wheat Max+=麦子上限+
Where Should I Go?=我该去哪里呢？
Intermediate=中级
Primary=基础
Beginner=初学者
Advanced=高级
 time=时长
Sloth Template slot=树懒模板插槽
Watch ads to get some rewards.=看广告以获得一些奖励。
 Extension=扩展
Wanderer's Robe=流浪者长袍
Wine=酒
Wreath=花环
Spear Class - =长枪课程 - 
Skeleton=骷髅
Spiritual=精神=
I taught it to pray and it started to pray with me. It is surprisingly pious.=我教它祈祷，它开始和我一起祈祷。 真是出奇的虔诚。
Flower=花
They're known as dangerous monsters that reside near the Village, but I think they're cute. ...I should ask Father if I can keep one at home!=他们被称为居住在村庄附近的危险怪物，但我认为他们很可爱。 ......我应该问问爸爸我能不能在家里养一个！
This flower is called Yggdrasil. You can feel the intense vitality from it.=这朵花叫做 Yggdrasil。 你可以从中感受到强烈的生命力。
You can use the inspiration gained from sacred rituals to learn abilities from the Astral World.=您可以使用从神圣仪式中获得的灵感来学习星界的能力。
It is good at stealth missions. It is able to sneak up on enemies before they even notice it.=擅长隐身任务。 它能够在敌人注意到之前偷偷接近他们。
It is a forest just outside the town. There is a lumberjack's workshop in the foreground.=这是镇外的一片森林。 前景是一个伐木工人的作坊。
It looks sluggish. But when tackling, it moves at an incredible speed.=它看起来很迟钝。 但在抢断时，它的移动速度惊人。
It might be good for cooking if it was a little bigger, but since it is small, let's make a pet of it.=稍微大一点的话，做饭应该也不错，但毕竟太小，还是当成宠物吧。
It's made of several pieces of leather stuck together after being pressed under a heavy rock for several days, making it quite sturdy.=它是由几块皮革在一块沉重的岩石下压了几天后粘在一起制成的，非常坚固。
Creator=造物主
Hermit=隐士
earth=地
wind=风
Ultimate Love=极致的爱
 Max+=上限+
 Ice=冰
 ice=冰
 Cream=激凌
 info=信息
 Leather=皮革
 Shield=盾牌
 Log=日志
 Loop=循环
 Flowers bloom naturally near this fairy. ...Hmm? It looks like there are also more weeds growing than usual.=在这个仙女附近，鲜花自然绽放。 ...唔？ 看起来杂草也比平时长得更多。
 Make =制作
 Firewood=柴火
 Level up=升级
 Magic circulation=魔法循环
 Tournament - Round =锦标赛 - 回合
 quest information=任务信息
 stamina=体力
unlock cost=解锁费用
summon cost=召唤费用
special level up cost=特殊升级成本
magical level up cost=魔法升级成本
progress cost=进度成本
Base Status=基础状态
Anchovy Sandwich=凤尾鱼三明治
Elastic Leather=弹性皮革
Gold=金币
Love=爱
Sea Breeze Amulet=海风护身符
Stone Statue=石像
Wooden Statue=木制雕像
Weed=杂草
Holy Water=圣水
About=关于
luck=幸运
School=学校
Statues=雕像
ACHIEVEMENT=成就
Ads=广告
Adventurers Armor=冒险者护甲
Animation=动画
Announce=公告
Bacon Egg=培根鸡蛋
Recipe=食谱
Bamboo=竹
Create Goddess Statues=制作女神雕像
Current research=当前研究
Cuisine=料理
Current=当前
Talent=天赋
Date=日期
strategy=策略
Bread=面包
Magic Fiber=魔法纤维
Mithril=秘银
Hot=热
Bone=骨头
Kill all =杀死所有
Read=阅读
Learn wind magic by reading the Wind Spellbook. It takes a lot of inspiration to learn.=通过阅读风魔法书来学习风魔法。 学习需要很多灵感。
Thank you=谢谢你
Thank you very much=非常感谢你
The Diary=日记
the Sister=姐姐
The Dominator=统治者
The Destroyer=毁灭者
The Arbitrator=仲裁员
Thunder=雷
Dr. Monster=怪兽博士
Herb Addict=药草瘾君子
Knight=骑士
Talk with Dr. Monster=与 怪物博士 交谈
Explain the Circumstances=说明情况
Chicken Steak=鸡扒
Malice=恶意
Smelly Sachet=臭香包
Shrine=神殿
Cooking Researcher=烹饪研究员
Goddess Statue=女神雕像
Manure=肥料
Paper=纸
Bandit Note=强盗笔记
Ask the Circumstances=询问情况
Bandit Hideout=强盗藏身处
Dessert Carnival==甜品嘉年华
Fairy Drop=仙女掉落
Emerald=翡翠
Tournament - =锦标赛 -
Final=决赛
Semifinal=半决赛
Steel=钢
Sin=罪恶
Sapphire Jewelry=蓝宝石首饰
Ruins=废墟
Return it little by little=一点一点地归还它
Jewelry=首饰
Drinking wine with Father=与父亲喝酒
Dessert Carnival Recipe=甜点嘉年华食谱
Destroy the hideout=摧毁藏身处
Bronze chest=青铜宝箱
Vegetable Garden=菜园
Weakened Demon King=虚弱的魔王
Deep=深处
Report to Authorities=向有关部门报告
Report to the Knights=向骑士报告
A small plant with aromatic or medicinal properties.=一种具有芳香或药用特性的小植物。
The Sister went to sleep=姐姐睡着了
The Sister died=姐姐死了
Trashed Room=垃圾房
Traces=踪迹
Moderately sized firewood.=大小适中的柴火。
Monster Flock=怪物群
Invite Norn to Join=邀请 Norn 加入
Don't go to Hospital=不要去医院
Demon Kingdom - =恶魔王国 - 
Beg for Engagement ring=求婚戒指
Increases drop chance by 1.5x for 1 hour. (Calculated after all other bonuses)=增加 1.5 倍掉落几率，持续 1 小时。 （在所有其他奖金之后计算）
Like Flowers=像花一样
Milk=牛奶
Monsters Attack=怪物攻击
Doubles=双倍
seed=种子
Butter Toast=黄油吐司
for 1 hour=持续1小时
Chicken=鸡
Auto Level Up Slot=自动升级插槽
Use this to recover squad automatically when it run out of stamina.=当队伍体力耗尽时，使用这个可以自动恢复队伍。
Tell me! teacher!=告诉我！老师！
Vast Desert=浩瀚沙漠
Repairsmith=修理工
Sewer=下水道
Abyss=深渊
Rice=大米
Rice Ball=饭团
Give the girl a new flower.=给女孩一朵新花。
The girl gently grasped the flower and smiled shyly.=女孩轻轻地握住那朵花，害羞地笑了笑。
Torn Diary=撕破的日记
Oasis=绿洲
Squad Slot=队伍插槽
Silver chest=银甲
Spellbook=法术书
Sign of Decisive Battle=决战的征兆
Sapphire=蓝宝石
Rocky Hill=落基山
Top=山顶
Regeneration=恢复
Mushroom Saute=炒蘑菇
Mushroom=蘑菇
Muscle Gym=肌肉健身房
Pelt from beasts.=野兽的毛皮。
A timid girl who lives in the Village. She may not be ready to leave the Village yet.=一个住在村子里的胆小的女孩。 她可能还没有准备好离开村庄。
Pick=拾
Statue of Muscle=肌肉雕像
Scrap Metal=废金属
Rock Grilled Steak=岩烤牛排
additional=附加
+50% chance to drop item, research and seeds from monster for one hour. More, More, MORE!=+50% 几率从怪物身上掉落物品、研究和种子持续一小时。 更多，更多，更多！
Rem=移除
Pat my head=拍拍我的头
No=不
Recover=恢复
Tan Pelt=棕褐色毛皮
require=需要
Are you going to go to school? That's good. Well, there are three types of schools in Academic City.=你要去上学吗？ 那挺好的。 嗯，学术城一共有三种学校。
The following action will be locked.=以下操作将被锁定。
Sorcerer=巫师
The salty flavor of the dish soothes your weary body.=这道菜的咸味可以舒缓疲惫的身体。
Weave Wreaths=编织花环
Wreath made of flowers. The girl will be happy.=用鲜花做成的花环。 女孩会很开心。
Standing Quietly=静静地站着
Rusty Sword=锈剑
Rocky Road=石板路
Description=介绍
Some of these aren't weeds; they're herbs! Let's sort them out!=其中一些不是杂草； 它们是草药！ 让我们把它们整理出来！
A humanoid that has the intelligence to handle tools.=具有处理工具智能的类人动物。
Riverbank=河岸
Check this to show imported pictures.=选中此项以显示导入的图片。
Select multiple pictures that have the appropriate name.=选择具有适当名称的多张图片。
drops=掉落
defeats=失败
Poison Potion=毒药
Poison Weed=毒草
Picture Menu=图片菜单
External Links=外部链接
Hotkey list=快捷键列表
Shortcut=快捷方式
Physical formation=物理形态
The ally's physical defense increases by 50%. Double effects increase it by 125%.=友方物理防御增加50%。 双重效果增加 125%。
Magical formation=魔法形态
Toughness=韧性
If you export when no images have been imported, you will get blank images with the default file names=如果在没有导入图像时导出，您将得到具有默认文件名的空白图像
Request Payment=请求付款
Punish the Bullies=惩罚恶霸
You can manage your party here. Read subcategories for details.=您可以在这里管理您的队伍。 阅读子类别了解详情。
Power-=能力-
Pork=猪肉
Pirate Attack=海盗袭击
Pick Weeds=拔草
Drop=掉落
The amount of raw magical potential that you've stored.=你储存的原始魔法潜能的数量。
The bodily capacity necessary to perform physical techniques.=执行物理技术所需的身体能力。
It would hurt if you were pecked by its beak.=如果你被它的喙啄一下会很痛。
Its bite is painful, but not venomous. Be careful because it is quick.=它的叮咬很痛，但没有毒。 要小心，因为它很快。
Plant=植物
Herb=草药
Material=材料
Complete=完成
Progress=进行中
Get flower=采花
Squad=队伍
Rename=重命名
A currency made of a metal that doesn't degrade.=由不会降解的金属制成的货币。
I've heard that wolves are dangerous around here, so I want to be able to take them down. Will you keep an eye on me?=我听说这里的狼很危险，所以我想消灭它们。 你会一直盯着我吗？
Wolves killed by Norn=被Norn杀死的狼
She has to use a skill to defeat it=她必须使用技能来打败它
Content=内容
Well, thank you! Oh, is there more meat? That's pretty addictive!=嗯，谢谢！ 哦，还有更多的肉吗？ 这太让人上瘾了！
Answer Fenia=回答芬尼亚
Troll=巨魔
Training Area=训练区
Rank=段位
Elixir=仙丹
You can select actions or dungeons here. Read subcategories for details.=您可以在此处选择动作或地下城。 阅读子类别了解详情。
use=使用
Library=图书馆
Leatherwork=皮革加工
Leave the Village Alone=独自离开村庄
Leave the Village Together=一起离开村庄
Let's summon familiars and have them do various things.=让我们召唤使魔并让他们做各种事情。
ExpLv=经验等级
BonusLv=奖励等级
Magic=魔法
\"Attack/Defense\" to=\"攻击/防御\" 为
display current resource amounts=显示当前资源数量
Drink=喝
Tea=茶
Ask about spellbook=询问法术书
Max:=最大:
Concentrate=专注
I know about red slimes, yellow slimes, green slimes, and...well, what kind of slimes are you looking for?=我知道红色史莱姆、黄色史莱姆、绿色史莱姆，还有……好吧，你要找哪种史莱姆？
Pelt=毛皮
Part-time job. Some of these Weeds might be Herbs.=兼职工作。 其中一些杂草可能是草药。
The taste is divine.=味道好极了。
Pray=祈祷
rare enemies=稀有敌人
main enemies=主要敌人
You max level=你的最高等级
Durable=耐用
Overlay leather to make a tough, sturdy piece of leather.=覆盖皮革，制成坚韧、坚固的皮革。
A routine that becomes second nature.=成为第二天性的例行公事。
Decide to enter =决定进入
school. There's no turning back, so think carefully about this decision.=学校。 没有回头路可走，所以请仔细考虑这个决定。
Medium speed=中等速度
Slowest speed=最慢速度
Fastest speed=最快速度
Recommended for new players=新玩家推荐
Slash=砍杀
Efficiency=效果
Upgrade Action=升级动作
Next is about ranks...good habits lead to a better personality.=接下来是关于段位……好的习惯会带来更好的性格。
Local specialty. Salty.=当地特色。 咸。
level=等级
When you're a little stronger, I'll we can spar.=等你再强一点，我就可以切磋了。
Suitable wood for making firewood.=适合做木柴的木材。
Ring of flowers.=花环。
Bully=恶霸
Everything starts from here.=一切从这里开始。
Lord of the Cave=洞穴之王
Stab=刺
Alright, let's learn about skills. Powerful attacks consume energy.=好吧，让我们学习一下技能。 强大的攻击会消耗能量。
An unidentified small plant. For those without knowledge, it is just a weed.=一种不知名的小植物。 对于没有知识的人来说，它只是一株杂草。
Expand=打开
Pouch=口袋
You're a full-fledged lumberjack! Alright, from now on, you can sell your firewood!=你是一个成熟的伐木工人！ 好吧，从现在开始，你的柴火可以卖了！
How do you split Wood? It's just you and the Wood. Don't think about anything else. Feel it.=你如何拆分木头？ 这只是你和木头。 别想别的了。 感受一下。
Expansion of Firewood Shelves=柴火货架的扩展
Lumberjack=伐木工人
Workshop=车间
Welcome. This is the first time I've seen you here. Well, have something to eat.=欢迎。 这是我第一次在这里见到你。 嗯，吃点东西吧。
The value gained from Offline Bonus will decay over time.=从离线奖励中获得的价值会随着时间的推移而衰减。
The base value of Offline Bonus is reduced to 50% for the first day offline, 40% for the second day, 30% for the third day, 20% the fourth day, and 10% for 5 days or longer.=离线奖金的基本值在离线第一天降至50%，第二天降至40%，第三天降至30%，第四天降至20%，5天或更长时间降至10%。
The maximum factor is from 0.5 ~ 0.95. Multiplicative factor does not affect the minimum factor.=最大系数为0.5～0.95。乘法因子不影响最小因子。
Meaning the offline bonus would average out to 20% value for 10 days offline. This can be improved with additive and multiplicative bonuses.=这意味着离线奖金将在离线10天内平均达到20%。这可以通过加法和乘法奖金来改善。
Exit=退出
For example, the base value for 10 days=例如，10天的基本值
day=天
Additive modification will make it take longer for the value to diminish to the minimum value. For example, "+1" means it will take +1 hour longer.=添加修改将使该值减少到最小值所需的时间更长。例如，“+1”意味着它将多花+1个小时。
So with a +24 additive factor, that would change the base value to 50% for 1 day and 6 hours offline, 40% for 2 days and 12 hours, 30% for 3 days and 18 hours, 20% for 5 days, and 10% for 6 days or longer offline.=因此，在+24加性因子的情况下，离线1天和6小时的基本值将更改为50%，离线2天和12小时的基础值更改为40%，离线3天和18小时的基础价值更改为30%，离线5天的基础价值为20%，离线6天或更长时间的基础价值改为10%。
So with a multiplicative factor of 200%=所以乘数为 200%
Multiplicative modification increases the maximum factor (0.5 by default).=乘法修改会增加最大因子（默认情况下为0.5）。
So the maximum factor is from 0.5 ~ 0.95. Multiplicative factor does not affect the minimum factor.=因此，最大系数为0.5～0.95。乘法因子不影响最小因子。
(max)=(最大)
If it's 10 days,=如果它是10天，
2nd=第2
4th=第4
3rd=第3
5th=第5
The result is =结果是 
Multiplicative=乘法
Reset all on this page=重置本页所有
Guild Point=公会点数
Ancient Spell=远古法术
Book of Wisdom=智慧之书
Will Speed=意志速度
Wind Cannon=风炮
Wind Magic Conversion=风魔法转换
Wind Step=风步
Work efficiency=工作效率
Worship=崇拜
Wyvern=飞龙
Concentration=专注
World is mine.=世界是我的。
Fate rate=命运率
Kind=善良
First of all, raise the maximum value of stamina, because you may not have the basis for accumulating stamina yet. Assign habits to your "Stamina Cap Extension" routine.=首先，提高体力的最大值，因为你可能还没有积累体力的基础。 将习惯分配给您的“体力上限上限扩展”程序。
You can get monster research by defeating monsters. So what do you think you need to get more research? The answer is "Luck".=击败怪物可以获得怪物研究。 那么你认为你需要做更多的研究吗？ 答案是“幸运”。
chance multiplier=几率乘数
Started date=开始日期
active=活跃
Even though you can read, if you try reading the spellbook, it would still be difficult to understand because you don't have enough "inspiration".=即使你能阅读，如果你尝试阅读魔法书，它仍然很难理解，因为你没有足够的“灵感”。
Bag=包
New Text=新文本
Time=时间
lovers=爱人
from last dark ritual=从上次黑暗仪式
Familiar=密友
Out of Village=村外
Mucus Attack=黏液攻击
Neutral=中立
Expand Material Bag=展开材料袋
Wood=木头
attacked=攻击了
damage=伤害
Feather Tackle=羽毛反抗
Talk with Bully=和恶霸交谈
Talk with Girl=和女孩交谈
Quit=退出
Back=返回
Slime=史莱姆
Just go back to action screen.=返回操作屏幕。
The current dungeon will continue.=目前的地下城将继续。
Eat this seed to reveal a tiny bit of your hidden potential.=吃下这颗种子可以揭示你隐藏的潜能。
You exit the battle and return to the action screen.=您会退出战斗并返回到操作屏幕。
It lives off the grass around here. If you do not approach, it will not notice you.=它靠附近的草地生活。 如果你不靠近，它不会注意到你。
Any seeds=任何种子
Friendly formation=友军阵型
Duration=持续时长
Cooldown=冷却时长
Habitat=栖息地
Delete=删除
Export=导出
Norn's Special Training=诺恩的特殊训练
Bestiary=兽语
The most dangerous monster near the village. It can even hurt adults.=村庄附近最危险的怪物。 它甚至会伤害成年人。
Refresh=刷新
Make squads of allies and have them challenge quest.=组建队友小队并让他们挑战任务。
Delete imported images.=删除导入的图片。
1st squad=第1小队
You can see information from the monsters you've encountered and defeated.=你可以看到你遇到和击败的怪物的信息。
Get Muddy Mucus a lot=得到很多浑浊的粘液
Hero=英雄
Add all=添加全部
free=空闲
Regular=常规
Enter name...=输入名称...
fire=火
Check your skills. Skills are there to set up companions.=检查你的技能。 技能是用来建立同伴的。
Fireball=火球
power=力量
You can assign skills to your allies.=您可以将技能分配给您的队友。
Also, Skills can have Additional Effects. Some Additional Effects only work when a specific battle formation is active, but Additional Effects listed in the help section under the [etc] category work at all times. Additional Effects also work when using Default Skills.=此外，技能可以有附加效果。 某些附加效果仅在特定的战斗编队处于活动状态时才有效，但 [etc] 类别下的帮助部分中列出的附加效果始终有效。 使用默认技能时，附加效果也有效。
Read the "Additional Effect" description for more information.=阅读“附加效果”描述以获取更多信息。
The "Assigned Skill" is activated at a cost. If you can't afford to pay the cost, the "Default Skill" will be used instead. You can only assign a skill to allies who have the required rarity (stars) and attribute. "You" and human allies can use any skill.=“分配技能”是有代价的。 如果您支付不起费用，则会使用“默认技能”。 您只能将技能分配给具有所需稀有度（星星）和属性的队友。 “你”和人类队友可以使用任何技能。
Air Cutter=风刃
Conversion=转换
Bullet=子弹
Learn earth magic by reading the Earth Spellbook. It takes a lot of inspiration to learn.=通过阅读地之魔法书来学习地之魔法。 学习需要很多灵感。
Perform a ritual.=进行一个仪式。
Maxed Allies Bonus=队友加成上限
Next=下一个
Enhance the effect of sacred ritual.=增强神圣仪式的效果。
Miracle Stone=奇迹石
Power item. With just having this on you, it feels like the day can only go better, so, let's go!=动力项。 有了这个，感觉日子只会过得更好，所以，走吧！
Lucky Rabbit's Foot=幸运兔脚
Power item. If you have this, a miracle will happen someday!=动力项。 如果你有这个，总有一天会发生奇迹！
Morning routine. Let's pray for a safe day.=早上的日常。 让我们祈祷平安的一天。
This has effects about locked contents.=这对锁定的内容有影响。
Calm Pixie=平静的精灵
Efficient seed collection!=高效的种子采集！
Does not meet the conditions.=不符合条件。
I will give you my great power.=我会给你我强大的力量。
Let's pray!=让我们祈祷吧！
Let's bully the weak!=让我们欺负弱者！
Exp multiplier=经验乘数
Exp sum=经验总和
Carefree Pixie=无忧无虑的精灵
Butler Spirit=精灵管家
Cheerful Pixie=欢快的精灵
Collect the seeds!=收集种子！
Enhance energy.=转换能量。
Greater Demon=大恶魔
Arrogant Fairy=狂妄小仙女
Artist's Dryad=艺术家树精
Allocate Habits to fill the bars.=分配习惯以填充条形图。
The more Habits you allocate and more Habit Efficiency you have, the faster the bar will fill. At maximum fill speed, the bar will remain full and say it is "Capped".=您分配的习惯越多，习惯效率越高，进度条填充的速度就越快。 在最大填充速度下，条形图将保持填充状态并表示它已“上限”。
Each time that a routine bar is full, you will gain a level or resource.=每次事务栏满时，您将获得一个级别或资源。
To quickly assign or remove Habits, hover over a routine and:=要快速分配或删除习惯，请将鼠标悬停在事务上，然后：
Hot keys for PC=电脑快捷键
Press [Z] to remove all Habits assigned to the routine.=按 [Z] 删除分配给事务的所有习惯。
The formula for effect values ​​depends on the routine.=效果值的公式取决于事务。
The number of Habits is equal to your Rank.=习惯的数量等于您的段位。
Press [S] to allocate one Habit.=按 [S] 分配一个习惯。
Press [R] to remove all Habits on the visible page.=按 [R] 删除可见页面上的所有习惯。
Press [A] to allocate all unassigned Habits.=按 [A] 分配所有未分配的习惯。
Physical Dryad=物理树精
Hmm! I know everything!=唔！ 我知道所有的东西！
I like this seed! Give me some!=我喜欢这个种子！ 给我一些！
I'll take your luggage for a moment.=我帮你拿一下行李。
Lesser Devil=小恶魔
Let me take care of you.=让我来照顾你。
Press this to reset all habits on all pages.=按此重置所有页面上的所有习惯。
Pick Flowers=拾起花儿
Ask about seeds=询问种子
Locket=挂坠盒
It seems that the flowers she cherished have been stepped on by bullies.=看来，她珍爱的花朵，已经被恶霸践踏了。
Investigate with the Knights=与骑士一起调查
I tried to resist him, but I failed to protect her...and lost my right arm.=我试图反抗他，但我没能保护她……失去了我的右臂。
Hear her words=听她的话
Hear her will=听她的意愿
Escape=逃离
Choose a present=选择礼物
Artificial Arm=假肢
Arrived in the cave=到达山洞
A Group of Monsters=一群怪物
Ask him to accompany you=叫他陪你
Crimson necklace=深红色项链
Awards Ceremony=颁奖典礼
Remember me!=记住我！
Take over the Hideout=接管藏身处
Teddy bear=泰迪熊
Fallen Sister=堕落的姐姐
Entrust the Holy Sword=委托圣剑
Destroyed=已摧毁
Decline Training=谢绝训练
Filled with Emptiness=充满空虚
Get treasure=获取宝物
Holy Sword=圣剑
Orphanage=孤儿院
Increases drop chance by 1.5x for 1 hour. (Calculated after all other bonuses)=增加 1.5 倍掉落几率，持续 1 小时。 （在所有其他奖金之后计算）
Dragon Claw=龙爪
Dragon Liver=龙肝
Griffon Feather=格里芬羽毛
Bamboo Shoot=竹笋
Engagement Ring=订婚戒指
Flower Bookmark=花卉书签
About School=关于学校
Will reset Levels in Routine and Familiar, and set Rank to 0.=将重置 事务 和 密友 的 等级，并将 段位 设置为 0。
Valley Village=山谷村
Valley=山谷
Utility=效用
Wait for the Knights=等待骑士
Train insight=训练洞察力
In return this will change (not add) your Talent with the new value. Higher Talent will allow for faster Sacred Rituals=作为回报，这将改变（而不是增加）你的新价值。 更高的天赋将允许更快的神圣仪式
Tournament=比赛
Titan=泰坦
Total level multiplier=总等级乘数
Transform into power=转化为动力
Traveller=旅行者
Upgrade=升级
Transform into evil=转化为邪恶
Physical=物理
Magical=魔法
Special=特殊
summoned=召唤了
Check to enable auto recoverer.=勾选启用自动恢复。
There are no compatibility between=不兼容在
Added action. Modified summon system(sorry, but currently magi stone is not worthwhile.)=增加了动作。 修改召唤系统（对不起，但目前魔法石不值得。）
and=和
Use Powder+=使用粉末+
Village Chief=村长
permanent=永久
You can refresh quests once every 20 hours.=您可以每 20 小时刷新一次任务。
quests=任务
Progressing quest won't be refreshed. (Available)=进行中的任务不会刷新。 （可用）
Form a Squad and send it on a Quest.=组建一个小队并派遣它执行任务。
Any number of allies can be added to the squad. When a quest is in progress, allies cannot be added to the squad. They can be removed as long as there is more than one ally in the squad.=可以将任意数量的盟友添加到小队中。 当任务正在进行时，无法将盟友添加到小队中。 只要小队中有不止一名盟友，就可以将其移除。
Third Eye=第三只眼
Tamer Class=驯兽师课程
Task=任务
Teahouse=茶馆
This is value=这个价值
Sin drop chance multiplier=罪恶掉落几率乘数
Sell=出售
Set=设置
Nectar=花蜜
Secondary Equipment=次要装备
Scribe=抄写员
Second Fang=第二方
Sacred ritual=神圣的仪式
Ruler's Force=君主之力
Ruby ticket=红宝石票
amount=数量
Stats=统计
Sandworm=沙虫
Status Up=状态上升
Spirit Shrine=精神神殿
It will automatically activate if the squad runs out of stamina, consuming an "auto recover" item.=如果小队耗尽体力，它会自动激活，消耗“自动恢复”物品。
Once used, it will recover the squad as many times as needed until the quest is completed.=一旦使用，它将根据需要多次恢复小队，直到任务完成。
Buy Beef=购买牛肉
Butter=黄油
Body=身体
Charisma=魅力
Chat=聊天
special cost=特殊成本
Preferred Skill=首选技能
Swing=摇摆
Wolf Claw=狼爪
To Reincarnation=转生
Sword Class=剑术课程
Swift Spearman=迅捷长枪兵
Tactical Class=战术课程
Study Ancient Spells=Study Ancient Spells=
Swordsmith=铸剑师
Stripping skill=剥皮技能
Spiritual=精神
Smuggle Poison Potion=走私毒药
Slot=插槽
Seed max+=种子上限+
Rod Class=鱼竿课程
Selected=已选择
Saint's Right Arm=圣女右臂
Shipboard=船上
RockyRoad=石板路
result=结果
Repair Bone=修复骨头
Rebellious Priest=叛逆牧师
Regen=回复
Collect Flower=收集花朵
Mana charge=法力充能
Beef Steak=牛排
Loop action efficiency+=循环动作效率+
Library Grade=图书馆级别
Study Ancient Spells=研究古代法术
Square=广场
Squeeze=挤压
Peck=啄
Add one daily quest slot, more quests, more rewards !=添加一个每日任务槽，更多任务，更多奖励！
Add one more squad for doing quests allowing running multiple quests in parallel.=添加一个小队来执行允许并行运行多个任务的任务。
Start=开始
TalkWithFather=与父亲交谈
Template=模板
Completed!=已完成！
Brown Slime=棕色史莱姆
Bluebird=蓝鸟
Catch Fish=捉鱼
Cook Crayfish Stew=炖小龙虾
Charity Larva=慈善幼虫
Blazing Aura=Blazing Aura=
Ask about destiny=询问命运
Ask about stamina=询问体力
Baked=烘焙
Periodically invest a certain amount of each seed on a chosen party member. Help greatly with seed management and party level up. (can be upgraded in Astral World)=定期将一定数量的每种种子投资于选定的党员。 极大地帮助种子管理和党的升级。 （可在星界升级）
There are several rituals. Read the subcategories for details.=有几种仪式。 阅读子类别以了解详细信息。
Form your party!=组建你的队伍！
Press [X] to remove one Habit.=按 [X] 删除一个习惯。
Each time that a routine bar is full, you will gain a level or resource.=每次事务栏满时，您将获得一个级别或资源。
Aim to be an excellent =旨在通过改进技术成为一名优秀的
by refining the technique. When you execute Dark Ritual, the accumulated technology is lost and returned to "talent".=当你执行黑暗仪式时，积累的技术会丢失并返回到“天赋”。
















============正则

Last login : (.*)\n(.*) ago.=最后登录 : $1\n$2 之前.
You attacked (\w+) for (\d+(?:\.\d+)?) damage.=你攻击$1造成 $2 点伤害
(\w+) used (\w+(?: \w+)?) and recovered (\d+(?:\.\d+)?) mana.=$1使用$2恢复了$3法力值。
Talk with (\w+(?: \w+)?) (\d+/\d+)=与 $1 交谈 $2
Talk with (\w+(?: \w+)?)=与 $1 交谈
Max (\w+(?: \w+)?)( |<|$)=$1上限$2
(\w+(?: \w+)?) (?:Max|max|Cap)( |<|$)=$1上限$2
(\w+(?: \w+)?) regen( |<|$)=$1回复$2
(\w+(?: \w+)?) speed( |<|$)=$1速度$2
(\w+(?: \w+)?) (?:Gain|gain)( |<|$)=$1获取$2
(\w+(?: \w+)?) drop( |<|$)=$1掉落$2
(\w+(?: \w+)?) amount( |<|$)=$1量$2
ED(\d+)=结局$1
You have (\d+) now.=你现在有$1个.

============忽略

<color=#FF4646>
<color="white">
</color>
<sprite=0>
<sprite=1>
<sprite=2>
<sprite=3>
<sprite=5>
<sprite=7>
<indent=180>
</indent>
<b>
</b>
<i>
</i>
<u>
</u>


============忽略正则




============忽略检测

X
x

e

K
M
B
T

D
C
B
A

aaafdasfsdgfdasfg

wiki
Wiki
Shift
Ctrl
Samurai Games
App Store
Google Play Store
Steam
Overlay
English
Discord

